#__#_#__
##_#_##_
###_##__
__#_####
_###*_@#
###_#_#_
#____#__
#_#____#