##_##_#_
###__#__
________
#_#_#__#
#@__#__#
##_#_##_
#_#_##_#
_###*###