_#__##_#
_##_*#_#
#___###_
######__
#___#___
####___@
_###__#_
_#_##__#