HGHFHFHH
FHFFHHFH
FFHHHFHH
FFHFFFHF
HHFHFFHF
HHFFFHFF
FHHFSHHH
FFHFHHFH