HFFHFHFF
HHFHFHHF
HHHFHHFF
FFHFHHHH
FHHHGFSH
HHHFHFHF
HFFFFHFF
HFHFFFFH