FHHHHFFH
HFHSHHHF
HFHHFHHF
HHFFFFFF
HFFHHGFF
FFHFFFFH
HFHHFFFH
FHHFHHHH