| | Col 1 | Col 2 | Col 3 | Col 4 | Col 5 |
| Row 1 | _ | # | @ | _ | # |
| Row 2 | # | # | _ | # | _ |
| Row 3 | _ | _ | # | # | _ |
| Row 4 | # | * | # | _ | # |
| Row 5 | _ | # | _ | # | # |
